111111111
10C010C01
100010001
100011111
1P00E0001
1000000C1
100111111
100100C01
111111111