11111
1DCE1
11101
10001
10CD1
1C111
10101
1P0C1
11111
