11111111111111111
10C010C0111C00E01
1101D010011D10011
10001111010000111
1C1000100CD101111
1010D0C01000000C1
10110011100011111
1PC1000C00100C011
11111111111111111
