1111111111111111
10C010C000010001
1000100000010001
1000111110000001
1P00000000001111
1000000C00E00001
1001111111000001
100100C000000EC1
1111111111111111