1111111111111111
10C010C0000100E1
1000100000010001
10001111100P0001
1000000000011111
1000000CP0000001
1001111111000001
100100C0000000C1
1111111111111111