1111111111111
10C010C000P01
1000000000001
100E000011111
10C100000C001
1111111111111