11111111111111
10C010C000P001
10000000000001
100E0000111111
10C100000C0001
10010000000001
11111111111111